111111111111
10CCCCCf00E1
111111111111