1111111111111
10000C0000001
1000000000001
10000P0000001
100000E000001
1000000000001
1000000000001
1111111111111