111111111111111111111111111111
100000000000000000000000000001
10000000C000000000000000000001
100000000000000000000000000001
100000100000000P00000000000001
1000001000000000000C0000000001
100000100000000000000000000001
10000010000000000E000000000001
100000000000000000000000000001
100000000000000001111100000001
10000000C000000000010000000001
100000000000000000000000000001
100000000000000000000000000001
100000C000000000C0000000000001
100000000000000000000000000001
111111111111111111111111111111