11111111111111
1E000000000001
10000000C00001
1000C000000001
10000000P00001
100C0000000001
100000000C0001
11111111111111