1111111111111111111111
1000000000000000000001
10000000C0000000000001
1000000000000000000001
100000100000000P000001
1000001000000000000C01
1000001000000000000001
1000001000000000000001
1000000000000000000001
1000000000000000011111
1000000E00E00E00001001
1111111111111111111111