11111111111111
1E000000000001
10000000000001
10000000000001
1000C000P00001
10000000000011
10000000000001
11111111111111