1111111111111111
1000000000001111
1000000000001111
1000000000001111
10000PE000001111
1000000C00001111
1000000000001111
1000000000001111
1000000000001111
1000000000001111
1000000000001111
1000000000001111
1000000000001111
1000000000001111
1000000000001111
1111111111111111