111111111111
1000000001P1
100000000011
100000000001
100000000001
10000EC00001
100000000001
100000000001
100000000001
111111111111