111111111111111111111111111111
1PEC00000011111111111111111101
111111111111111111111111111111