111111111111
1PCCE0000CC1
111111111111
111111111111