111111111111
1PECjkyhbyj1
111111111111
